%%%%%%%%%%%%%%%%%%%%
%                  %
%                  %
%                  %
%                  %
%                  %
%              %%% %
%    % %       %.  %
%%%%%% %%%     %%% %
%      %           %
%      %%%         %
%      %           %
%      %           %
%      %           %
%%%%%% %           %
% P    %           %
%%%%%%%%%%%%%%%%%%%%