%%%%%%%%%%%%
% .        % 
%%%%%%%%%% % 
%          %
% %%%%%%%%%%
%          % 
%%%%%%%%%% %
% P        %
%%%%%%%%%%%%